..................###............
..................###............
..................###............
......####........###............
......####........###............
..................########.......
..................########.......
......######.....................
......######.....................
......######.....................
......######.....................
